1111111111111000111111111111
1000000000000000000000000001
1000000000000000000000000001
1000000001111111111100000001
1000000000000000000000000001
0000000000000000000000001100
1000000000000000000000001101
1000000001111111111100001101
1000000000000000000000000001
1000000000000000000000000001
1111111111111000111111111111