1111111111111000111111111111
1000000000000000000000000001
1000000000000101000000000001
1000000001111101111100000001
1000000011000000000110000001
0000000000000010000000000000
1000000011000000000110000001
1000000001111101111100000001
1000000000000101000000000001
1000000000000000000000000001
1111111111111000111111111111